R 1200 800
NO ./image/NO.xpm
SO ./image/SO.xpm
WE ./image/WE.xpm
EA ./image/EA.xpm
S ./image/ITEM.xpm
F  184,113,39 
C 51,198,227

        1111111111111111111111111
        1000000000110000000000001
        1011000001110000002000001
        1001000000000000000000001
111111111011000001110000000000001
100000000011000001110111111111111
11110111111111011100000000001
11110111111111011101010000001
11000000110101011100000000001
10002000000000001100000000001
10000000000000001101010000001
11000001110101011111011100N0111
11110111 1110101 101111000001
11111111 1111111 111111111111